BBBBBBBBBBBBBBBBBBBB
BT..B.........B.....
BBB.BBBBB.BBB.B.BBB.
B.B.....B.B...BSB...
B.BBBBB.B.B.BBBBB.BB
B.....B...B.B...B...
B.B.BBBBBBB.B.B.BBB.
B.B.......B...B.....
B.BBB.B.BBBBBBBBBBB.
B.B.B.B.B.......B...
B.B.B.B.B.BBBBB.B.BB
B.B.B.B.B.B...B.B...
B.B.B.BBB.B.B.B.BBB.
B...B.....B.B.B.....
BBB.BBBBBBB.B.BBBBBB
B...B.....B.B.......
B.BBB.BBB.B.BBBBB.B.
B.B...B.B.B.B...B.B.
B.BBB.B.B.BBB.B.B.B.
B.....B.......B...B.