BBBBBBBBBBBBBBBBBBBB
BT..B.....B.....B...
BBB.B.BBB.B.B.B.B.BB
B.B.B.B.B...B.B.B...
B.B.B.B.BBBBB.B.B.B.
B.B.B.....B...B.BSB.
B.B.BBB.BBB.BBB.BBB.
B.B...B.B...B.B.....
B.BBB.BBB.BBB.BBBBB.
B...B.....B...B...B.
BBB.BBBBBBB.B.B.B.B.
B.......B...B.B.B.B.
B.BBBBB.B.BBB.BBB.B.
B.....B...B...B...B.
B.BBB.BBBBBBB.B.BBB.
B...B.B.....B...B...
BBB.B.B.BBB.BBBBB.BB
B.B.B...B.B.......B.
B.B.BBBBB.BBBBBBBBB.
B...................