BBBBBBBBBBBBBBBBBBBB
BTB...B.............
B.B.B.B.BBBBB.BBB.B.
B...B.B.B...B.B...B.
BBBBB.BBB.B.BBB.BBBB
BS..B.....B...B.....
BBB.BBBBBBBBB.BBBBB.
B...B.......B.......
B.B.BBB.BBBBBBBBBBB.
B.B...B...........B.
B.BBB.B.BBB.BBBBB.B.
B.B...B...B.B.....B.
B.B.BBBBBBB.BBBBBBB.
B.B.........B...B...
B.BBBBBBBBB.B.B.B.BB
B.........B.B.B...B.
B.BBBBBBB.B.B.BBBBB.
B...B.B...B.B.B.....
BBB.B.B.BBBBB.BBBBB.
B.....B.............