BBBBBBBBBBBBBBBBBBBB
BT..B.........B.....
BBB.BBB.BBBBB.B.BBB.
B.B...B.B...B.....B.
B.BBB.BBB.B.BBBBBBB.
B...B...B.B.....B...
BBB.BBB.B.BBBBB.B.B.
B...B.B.B...B.B...B.
B.B.B.B.BBB.B.BBBBB.
B.B.B.B.B...B...B...
B.B.B.B.B.BBB.BBB.BB
B.B...B...B.....B...
B.BBB.BBBBBBBBB.BBB.
B.B...B...........B.
B.BBBBB.B.BBBBBBBBB.
B.B.....B.......B...
B.B.BBBBBBBBBBB.B.BB
B.B.BS......B.B...B.
B.B.BBB.BBB.B.BBBBB.
B.......B...........