BBBBBBBBBBBBBBBBBBBB
BTB...........B.....
B.BBBBBBBBBBB.B.BBB.
B...B.......B.B...B.
BBB.B.BBBBB.B.BBB.B.
B...B.B...B....SB.B.
B.BBB.B.BBB.BBBBB.B.
B.B...B.....B...B.B.
B.BBB.BBBBBBB.B.B.B.
B...B.B.......B...B.
BBB.B.B.BBBBBBBBBBB.
B...B.....B.....B...
B.BBB.BBBBB.BBB.B.B.
B.B...B...B...B...B.
B.B.BBB.B.BBB.BBBBB.
B.B.B.B.B.....B.....
B.B.B.B.BBBBBBB.BBBB
B.B...B...B...B.B...
B.BBBBBBB.B.BBB.B.B.
B.........B.......B.