BBBBBBBBBBBBBBBBBBBB
BTB...B...B.........
B.B.B.B.B.B.B.BBBBBB
B...B.B.B...B.......
BBBBB.BBBBBBB.BBBBB.
B...B.......B.B.....
B.B.BBBBBBB.B.B.BBB.
BSB...B...B.B.B.B...
BBB.B.B.BBB.B.B.BBB.
B...B...B...B.B...B.
B.BBBBBBB.BBB.BBB.BB
B...B...B.B...B.B...
B.B.B.B.B.B.BBB.BBB.
B.B...B.B.B.B.....B.
B.BBBBB.B.B.BBB.BBB.
B.....B...B.....B...
BBBBB.BBBBBBBBB.B.BB
B...B.....B...B.B...
B.B.BBBBB.B.B.BBBBB.
B.B.........B.......