BBBBBBBBBBBBBBBBBBBB
BT....B...........B.
BBBBB.BBB.B.BBBBB.B.
B..SB...B.B.B...B...
B.BBBBB.BBB.B.BBBBB.
B.....B.B...B.......
B.BBB.B.B.BBBBBBB.BB
B...B...B...B...B...
BBB.BBBBBBB.B.B.BBBB
B.B.......B.B.B.....
B.BBBBBBB.B.B.BBBBB.
B.B.......B.....B...
B.B.BBBBBBBBBBB.B.B.
B.B.....B.....B.B.B.
B.BBBBB.B.BBB.BBB.B.
B.....B...B.B...B.B.
B.B.BBBBBBB.BBB.B.B.
B.B.B...B.....B.B.B.
B.B.B.B.B.BBB.B.B.B.
B.B...B.....B.....B.