BBBBBBBBBBBBBBBBBBBB
BTB.................
B.B.BBBBB.BBBBBBBBB.
B.B.....B.....B.....
B.BBB.BBBBBBB.B.BBBB
B...BSB.......B.....
BBB.BBB.BBBBBBBBBBB.
B.B...B...B.B.......
B.BBB.BBB.B.B.BBBBBB
B...B.....B.B.....B.
B.B.BBBBBBB.BBBBB.B.
B.B.....B...B...B...
B.B.BBB.B.B.B.B.BBB.
B.B...B...B.B.B.B...
B.BBB.BBBBBBB.B.B.BB
B.B.B...B...B.B.B.B.
B.B.BBB.B.B.B.B.B.B.
B...B...B.B...B...B.
BBB.B.BBB.BBBBBBBBB.
B...B...............