BBBBBBBBBBBBBBBBBBBB
BTB.......B.....B...
B.B.BBBBBBB.B.BBB.B.
B.B.........B.....B.
B.B.BBBBBBBBBBBBBBB.
B.B...B.......B.....
B.BBB.BBBBB.B.B.BBB.
B.B.B.......B.B...B.
B.B.BBBBBBBBB.BBB.B.
B.B.........B.B.B.B.
B.B.BBBBBBB.B.B.B.BB
B.B...B...B.....B...
B.BBBBB.B.B.BBBBBBB.
B.......B.B...B...B.
BBBBBBBBB.BBBBB.B.B.
B...B...B.B...B.B...
B.BBB.B.B.B.B.B.BBB.
B.....B.B.B.B...B...
B.BBBBB.B.B.BBBBB.BB
B....SB.....B.......