BBBBBBBBBBBBBBBBBBBB
BTB.......B.........
B.B.BBBBB.B.BBBBBBB.
B.B.....B.....B...B.
B.BBBBBBB.BBBBB.B.B.
B.......B.B.B...B...
BBBBBBB.B.B.B.BBBBBB
B.B.....B...B.......
B.B.BBBBB.BBBBB.BBB.
B.B.B...B.B...B...B.
B.B.B.B.B.B.B.BBB.B.
B.B.B.B.B.B.B.B...B.
B.B.B.B.BBB.B.BBBBB.
B...B.B.B...B...B...
B.BBB.B.B.BBBBB.B.B.
B.B...B...B.....B.B.
B.B.B.BBBBB.BBBBB.B.
B.BSB...B...B.....B.
B.BBBBB.B.BBB.BBBBB.
B.......B.....B.....