BBBBBBBBBBBBBBBBBBBB
BTB.......BS......B.
B.B.B.BBB.BBBBB.B.B.
B.B.B...B.....B.B.B.
B.B.BBB.BBBBB.B.B.B.
B.B.B...B...B...B...
B.BBB.BBB.B.BBBBBBB.
B.....B...B.B.....B.
BBBBBBB.BBB.BBBBB.B.
B.......B.......B.B.
B.B.BBBBB.BBBBB.B.B.
B.B.....B.B...B...B.
B.BBBBB.BBB.B.BBB.B.
B.....B...B.B...B.B.
BBBBB.BBB.B.BBB.B.B.
B...B...B...B.B.B.B.
B.B.BBB.BBBBB.B.BBB.
B.B...B.....B.B...B.
B.BBB.BBBBB.B.BBB.B.
B...B...........B...