BBBBBBBBBBBBBBBBBBBB
BT..........B.......
BBBBBBBBBBB.B.B.BBB.
B...B.....B.BSB.B...
B.B.B.BBB.B.BBB.B.BB
B.B...B...B.....B.B.
B.BBBBB.BBBBBBBBB.B.
B.B.......B.....B.B.
B.BBBBB.BBB.BBB.B.B.
B.....B.B...B...B...
B.BBB.B.B.BBB.BBBBB.
B.B.B.B.B.B.B.....B.
B.B.B.BBB.B.BBBBB.B.
B.B.B.....B.....B.B.
B.B.BBBBBBBBB.BBB.B.
B.B.....B...B...B...
B.BBB.B.B.B.BBB.BBBB
B...B.B.B.B.B...B...
BBB.B.B.B.B.B.B.BBB.
B.....B...B...B.....