BBBBBBBBBBBBBBBBBBBB
BT..B.....B.........
BBB.B.BBB.BBBBB.BBBB
B...B.B.B.....B.....
B.BBB.B.BBBBB.BBB.B.
B...B.B....SB...B.B.
BBB.B.B.BBBBBBB.B.B.
B.B...B...B.....B.B.
B.BBBBBBB.B.BBBBB.B.
B.......B.B.B...B.B.
B.BBB.B.B.B.B.B.BBB.
B.B...B...B...B.B...
B.B.BBBBBBBBBBB.B.BB
B.B.............B...
B.BBBBBBBBBBBBBBB.B.
B...B.............B.
BBB.BBBBBBB.BBBBBBB.
B.B.......B.B.....B.
B.BBBBBBB.BBB.BBB.B.
B.............B.....