BBBBBBBBBBBBBBBBBBBB
BTB.............B...
B.B.B.BBBBBBBBB.B.B.
B.B.B...B...B...B.B.
B.B.BBB.B.B.B.BBBBB.
B.B.B...B.B.B...B...
B.B.B.BBB.B.BBB.B.B.
B.BSB.B...B...B...B.
B.BBB.B.BBB.BBBBBBB.
B.....B...B.....B.B.
BBBBBBBBB.BBB.B.B.B.
B.......B.B.B.B...B.
BBBBB.BBB.B.B.BBBBB.
B.....B.....B.B...B.
B.BBB.B.BBBBB.B.B.B.
B...B.B...B...B.B...
B.B.B.BBB.B.B.B.BBBB
B.B.B...B.B.B.B.....
B.B.BBBBB.B.BBBBBBB.
B.B.......B.........