BBBBBBBBBBBBBBBBBBBB
BTB...............BS
B.B.BBBBBBBBBBBBB.B.
B...B...B.......B...
BBBBB.BBB.B.BBBBBBB.
B.....B...B...B...B.
BBB.BBB.BBBBB.B.B.B.
B...B...B.B...B.B.B.
B.BBB.BBB.B.BBB.B.B.
B...B.....B.....B.B.
B.B.BBBBB.BBBBBBB.B.
B.B.....B.B.....B...
B.BBBBB.B.BBBBB.BBBB
B...B...B...B...B...
B.BBB.B.BBB.B.B.B.B.
B.B...B...B.B.B.B.B.
B.B.B.BBBBB.B.B.BBB.
B.B.B.B.....B.B...B.
B.B.BBB.BBBBB.BBB.B.
B.B...........B.....