BBBBBBBBBBBBBBBBBBBB
BT..BSB.....B.......
BBB.B.B.B.B.BBB.BBB.
B...B...B.B.B...B...
B.BBB.BBB.B.B.BBB.BB
B.B...B...B.B.B...B.
B.BBBBB.BBB.B.B.BBB.
B.....B.B.B...B.B...
BBBBB.B.B.BBBBB.BBB.
B...B.B.B...B...B...
B.B.B.B.B.BBB.BBB.B.
B.B...B.B...B.....B.
B.BBBBB.B.B.BBBBBBB.
B.....B.B.B...B...B.
BBBBB.B.BBB.BBB.B.B.
B.....B...B.B...B...
B.BBBBBBB.B.B.BBBBBB
B.B.......B.B.....B.
B.B.BBBBBBB.BBBBB.B.
B...B...............