BBBBBBBBBBBBBBBBBBBB
BT..........B...B...
BBBBBBBBBBB.B.B.B.B.
B.......B...B.B...B.
B.BBBBB.B.BBB.BBBBB.
B...B.B.B.B.....B.B.
B.B.B.B.B.BBBBB.B.B.
B.B.B.B.B.B.....B.B.
BBB.B.B.B.B.BBBBB.B.
B...B...B...B.B.....
B.BBBBBBBBBBB.B.BBBB
B.............B.B..S
B.BBBBBBBBBBB.B.B.BB
B.......B.....B.B...
BBB.BBBBB.BBB.B.B.B.
B.B.B.....B.B.B.B.B.
B.B.B.BBBBB.B.B.B.B.
B...B.B...B...B.B.B.
B.BBB.B.B.BBBBB.BBB.
B...B...B...........