BBBBBBBBBBBBBBBBBBBB
BT....B...B.........
BBBBB.B.B.BBBBB.BBBB
B...B.B.B.....B.....
B.BBB.B.BBBBB.B.BBB.
B.B...B...B...B...B.
B.B.BBB.B.B.BBBBB.B.
B.B...BSB.B...B...B.
B.BBB.BBB.BBB.B.BBB.
B...B.B...B.B.B.B...
B.B.B.B.BBB.B.BBB.B.
B.B.B...B...B...B.B.
BBB.BBBBBBB.BBB.B.B.
B...B...B...B.B...B.
B.B.B.B.B.B.B.BBBBB.
B.B...B...B.....B...
B.BBBBBBBBB.BBBBB.BB
B.....B...B.B...B...
B.BBB.B.B.BBB.B.BBB.
B...B...B.....B.....