BBBBBBBBBBBBBBBBBBBB
BT....B.............
BBBBB.B.BBBBBBBBBBB.
B..SB.B.B...B.....B.
B.BBB.B.B.B.B.BBB.B.
B.B...B.B.B...B.B.B.
B.B.BBB.B.BBBBB.B.BB
B.B.B.B...B.....B...
B.B.B.B.BBB.BBBBBBB.
B...B.......B.......
B.BBB.BBBBB.B.B.BBBB
B.B...B...B.B.B.B...
B.BBBBB.B.B.B.BBB.B.
B.....B.B.B.B.....B.
BBBBB.B.B.B.BBBBBBB.
B.....B.B.B.....B...
B.BBBBB.B.B.BBBBB.BB
B.......B.B.B...B...
BBBBBBBBB.BBB.B.BBB.
B.............B.....