BBBBBBBBBBBBBBBBBBBB
BT..........B.....B.
BBBBBBBBBBB.B.BBB.B.
B...B.......B.B...B.
B.BBB.BBBBBBB.B.BBB.
B...B.....B...B.BS..
BBB.BBBBB.B.BBB.BBB.
B.....B.B.B.B.B.....
B.BBB.B.B.B.B.BBBBB.
B...B...B...B.B...B.
B.B.BBBBBBBBB.B.B.B.
B.B.B...........B.B.
B.B.B.BBBBBBBBBBB.B.
B.B.B.....B...B...B.
B.B.BBBBB.BBB.B.BBB.
B.B.....B.....B.....
BBBBBBB.BBBBB.BBBBBB
B...........B.B.....
B.BBBBBBBBBBB.BBB.B.
B.................B.